4
0002220000
0002120000
0002022220
0222404120
0210482220
0222242000
0000212000
0000222000