7
0002222222
0022002082
0020002402
0024004002
0020422002
2220402022
2111110020
2222222220