8
0002222220
0222000020
2210422022
2114040082
2110404022
2222220020
0000022220