11
022220022222
220020020002
204022224002
200411110402
220000208022
022222222220