13
00222200
00211200
02201220
02004120
22040022
20024402
20080002
22222222