19
0222222200
0211110200
2221114222
2004240402
2044002402
2000020002
2222080222
0002222200