23
0022222000
2220002222
2000404002
2040004082
2224422222
0020011200
0021111200
0022222200