25
00000222222
02222210002
02002112202
02004110002
02002012022
22202242002
20400004402
20242002002
28002222222
22222000000