34
222222222222222
200000020000002
204024020422402
202004020000002
200022424224402
202020111020002
204001020140002
204284111202002
200001020100402
202214222410202
202041111102202
200000000000002
222222222222222