36
222222220000000
200000020000000
204400022200000
200404440222220
220220111000022
020282111222402
020204111000002
220204111402022
200222220222020
200000040004020
222222222220020
000000000022220