38
222222222222
211102000002
211002022002
211000002002
211002042202
211102404002
222222004402
022004044002
028044400202
022040200002
002000000002
002222222222