40
222220000002222
208022222222002
220400000004002
020202002222002
020040002222422
024022020404020
220400420000020
200020000002020
200022222422220
222220002000200
000021110040200
000021111200200
000021111222200
000022222200000