52
0000000002222200
0000000002000200
2222222222050222
2000000000010002
2044445555411182
2000000000010002
2222222222050222
0000000002000200
0000000002222200