58
22222222222200
21100200000222
21100204004002
21100242222002
21100008022002
21100202004022
22222202240402
00204004040402
00200002000002
00222222222222