72
222222222222222
222120000002222
221120400402002
211120220402002
211111002440002
221111400002402
222202222222002
200040000000022
200402004204022
204222040204402
200082002200002
222222222222222