73
000000022222222
000000020020002
022222220441112
020000000021112
020222222421112
220200000021112
200202404022222
202040404020000
208004020020000
222224044020000
000020000020000
000022222220000