74
000000022222
002222220002
222000010402
204002412422
200200812002
220222210002
020400252222
020220210020
020000012020
022240000020
000200222220
000222200000