75
000022220000
222220022222
200004000402
200424220002
222021510222
002011108200
002202422200
000200020000
000222220000