79
00000222222000
00022200002200
00020002200200
02224220020200
22000001120200
20042425120200
20440821520222
20044021120002
22000021140002
02224221020222
00020022200200
00022000002200
00002222222000