88
0222200222222
0200222200002
2250005055002
2040500005202
2010002220002
2222220002822
2050105005502
2000200020002
2250005024202
0200222220002
0222200022222