27
000000222222222
000000200000002
000000202020202
000000200404202
222222200040002
211200220404202
211000220404002
211200220222222
211202040402000
211000004002000
200222800222000
222202222200000