28
0000222200000000
2222200200000000
2004040202222222
2000400202515152
2204040222151512
0240400200515152
0284040000151522
0240400200515152
2204040222151512
2000400202515152
2004040202222222
2222200200000000
0000222200000000