29
222222220
211111120
200402022
204020402
224040402
020080002
022222222