32
02222220
02101120
02104120
22200422
20400402
20242202
20008002
22222222