42
2222202222222
2000222002002
2004000040802
2202422122002
0200111510402
0204202120202
0220000400002
0020022222222
0022220000000