55
22222222222
20000200002
20484444402
20000000002
22222022222
00021002000
00021002000
00021112000
00021002000
00022222000