65
2222222222
2200000002
2000242402
2044001412
2082221112
2222222222