78
02222200000
02080222222
02021150002
02011120002
22422040402
20002422222
20004000200
22222020200
00002000200
00002222200