83
0222222222222220
0208050505020022
0242005050020002
0202050505000002
0202005050022022
0202050505022020
0202005050022020
0202050505022020
0202005050022020
0202050105022022
2202222222222002
2000000000000002
2000222222222002
2222200000002222