85
00000222222222
00000200000002
00000200424202
02222220020402
02000204004002
22040000022202
20002422220002
20000402220222
22222110820220
00021114044020
00021112000020
00021112222220
00022222000000