87
0000002222200000
2222222000200000
2000221000200000
2004211002220000
2200111244022222
0204121400000002
0204222422020402
0200020000044202
0224420224240002
0211104804000222
0211124200022200
0211100222220000
0222222200000000