89
02222222220
02000200020
02044444020
22040404020
20400800020
20402222022
20021111102
22001111102
02222222222