99
222200000000000
200200000000000
200222222222200
200002200000200
211200004420200
211002200040222
211200224204002
211000208404002
211200204040002
201000204040222
200200200022200
200200002220000
222222222000000