2
2222200000
2008200000
2044202220
2040202120
2220222120
0220000120
0200020020
0200022220
0222220000