3
0222222200
0200000222
2242220002
2080400402
2011204022
2211200020
0222222220