6
0002222222000
2222000002000
2000122202000
2020200002200
2020404210200
2020050020200
2012404020200
2200002020222
0202221000082
0200000220002
0222222222222