9
02222222220
02002200020
02000400020
02402220420
02021112020
22021112022
20400400402
20000020082
22222222222