10
00222222
00200002
22244402
28041102
20411122
22220020
00022220