12
00222220
22200820
20041022
20014102
22205402
00200022
00222220