14
22222222
20020002
20411402
28415022
20411402
20020002
22222222