15
02222220
22000022
20404402
21111112
20440402
22208222
00222200