17
222222000
200002000
204442200
200211222
220011402
020080002
022222222