18
0022222222
0020002102
0220041112
0200402512
2202242022
2000400402
2000200002
2222222802
0000002222