21
00022222200
00020111200
22221111200
20022240222
20404004402
28040400002
20002220002
22222022222