22
222222220
200000020
202440020
201112020
221114022
020220402
024004002
020020082
022222222