24
22222200022222
20000222020012
20040402021112
20200402220012
20044400040812
22200400420012
00200424021112
00220000020012
00022222222222