30
002222222222
222000100002
200022422002
208410101422
220422422020
020000100020
022222222220