31
000222222
222210082
200444002
212212212
200040002
200412022
222200020
000222220