33
00002222220000
00222000022200
00200024000222
00200040004402
00204402400002
00220004000402
22222202422222
21180240020000
21211004220000
21111420200000
21111000200000
22222222200000