41
0000022222
0222220002
0201104202
0202150002
2205124022
2040040020
2000220820
2222222220