43
000000000222000
000022222282200
000021111240220
000021111204020
000021111040020
000020111200020
222222022222022
204040004002002
200004400040402
222040404002222
002200040402000
000200222222000
000222200000000