45
000000222200000
000000200222222
000000200002002
000000204400002
222222242002002
200210110222422
200212514000002
200212152020002
204411112022222
208402022020000
204442000020000
200002222220000
222222000000000