46
222200000000000
200222000000000
204002220000000
204040022200000
204040400222000
204040400002000
204040020002200
204002204440200
280222200000220
220202144444120
020222111111122
020001555555512
022221111111112
000022222222222