47
22222220000
20820022222
20440040002
20021224202
22421110002
22011122422
20022122002
20040040002
20020002002
22222222222