48
00022222000
00020802000
00020402000
00024142000
02221412200
22014141222
20041414002
20000100002
22222222222