49
2222222222222
2004040415112
2040404051112
2004040415112
2040404051112
2004040415112
2040404051112
2004040415112
2040404051112
2004040415112
2840404051112
2222222222222