50
0000000022222
0000000020002
2222222220202
2040404040002
2021212120422
2111111108020
2020202024222
2040404040002
2222222220202
0000000020002
0000000022222