51
222222200
200140222
201414002
254141802
201414022
200140020
222222220