54
0222222222200
0200022000222
0204000000402
0220022020802
0200220402022
0204111111020
2202220102020
2000004222020
2000200004020
2222242022220
0000200020000
0000222220000