57
22222222222222
21000000000002
21404040404002
21222222222002
21215040114522
21204040514820
21210040114420
21222222222120
21000000000020
21242424242420
21000000000020
22222222222220