59
00000002222000
22222222002222
20002211111002
20040022111202
22004002220202
02020400200002
02002040020002
02000204002002
02000020402022
02222002040020
00002200204020
00000228200020
00000022222220