60
22220000002222
21122222222112
25151111151512
20404040404042
24040484040402
20404040404042
24040404040402
21515111115152
21122222222112
22220000002222