61
000022222000
000220002222
000201150402
222202020802
200001512022
202022422020
200000404020
220020002220
022222222000