62
222222000
200002000
204002222
204511502
205115402
222200402
000200802
000222222