64
222222222222
200001110402
204445550482
200001110402
222222222222