66
0222200000
0200222220
2240220020
2004840020
2000224020
2221220222
0211140402
0221100002
0022222222