67
2222202222000000
2111202002222000
2111222004002000
2111122040042220
2211112200040020
2221110220404020
2022000020040020
2002202022202222
2040202400400002
2004800400004002
2000204044040222
2002222220022200
2022000022220000
2220000000000000