69
00000022220
22222220020
20000400020
20004228420
22421112020
02041110020
02021012022
02000202402
02400400002
02002222222
02222000000