71
2222200000000000
2111202222200000
2111222000200000
2111100044222220
2111100200200022
2112422220242002
2204002000004402
2004208040442002
2040404020004022
2000200402200020
2222220002222220
0000022222000000