77
00222220000
00200020000
22241422222
20001040002
20224220802
20001022222
22201020000
00200020000
00222220000