80
0000022222220
0000020020020
0000020044020
2222220420020
2111222020022
2100200402002
2100004040402
2100200402002
2111222020022
2222220400020
0000020820020
0000022222220