81
0000000000222222
0000000000200002
2222200022202202
2110222220400202
2110000040004202
2110022022000202
2110220402404202
2110200000400202
2110200402224002
2110204040040222
2220220204000020
0020000282204020
0022222222200220
0000000000222200