82
002222200
222080222
200404002
205151502
201404102
205151502
200404002
222222002
000002222