84
022222222222220
020000200220020
024440204400422
020400200111102
020040024122102
020020420111122
224040024122102
204004084111102
200022200222222
222220222200000