90
000222222200000
000200000200000
000204040220000
000222221122222
222222115100402
200484111124402
200040242220002
222220000000222
000022200222200
000000200200000
000000222200000