91
22222000000
20002222222
20400110402
22400114482
02000110402
02222222222