93
000022222000000
222220002000000
200040802000000
200402122222000
224022122002222
020011111042002
020422122002402
020002122000002
022204022222022
000202400000402
000200002220002
000222222022222