95
0022222222200000
0020000200200000
2220240040222200
2004002211200222
2020040211404002
2044004211002002
2200200111240002
0240802111204002
0200002111400022
0202240222000220
0200040000022200
0200222222220000
0222200000000000