97
000000222222222
000000200000002
000000240444002
000000200020402
000000200048402
000022240402022
000020004242020
222220200200020
211100204202220
211111000202000
211111204202000
222222220002000
000000022222000