98
02222202222220
02000222000020
22040402402420
20040800004022
20200220251112
20022040212212
22004000011112
02044024211112
02000200024022
02222204000020
00000222200220
00000000222200