100
00000022222220
00000220000022
00002200422002
00002002000402
00002020020202
00002040400402
22222220242002
20000000000022
20508455122220
22111111222000
02222222200000