1
00002222220000
00002000020000
02222004422222
02000200020002
02040004000402
02000220222222
22224220000002
20004020008002
20404020222222
22004020211120
02022000011120
02000022111120
02222222222220