5
02222200
02082220
02040020
22202022
21202002
21400202
21000402
22222222