16
0022222222
0020000222
0020400002
2220402202
2111040002
2111424022
2222020402
0002000802
0002222222