26
0222222222000
0200022002222
0204000000002
0224222022002
0200220502022
0204111111020
2202220102020
2000004222420
2000200004820
2222242022220
0000200020000
0000222220000
