35
2222222220
2000220020
2020404020
2005120020
2202181220
2242225222
2000000002
2000220202
2222220002
0000022222