37
0002222200
0002080200
0002444200
2222000200
2000104222
2041410122
2002121220
2222222200