39
22222222200
20000000200
20040404200
22024220200
02011011220
02211011020
00202242022
00240404002
00200000082
00222222222