44
00022222000
02220002220
22008404020
20022022022
20412140002
20212520002
20411100222
22242022200
00200020000
00222220000