53
0000022220000
2222220022222
2840000400402
2422204020202
2002002040002
2042000020222
2004024200020
2111111111020
2222222200020
0000000222220