56
002222200
002080200
002040200
222010222
200050002
205555502
200050002
222454222
002010200
002050200
002010200
002222200