63
000222220
222210022
204141002
284202402
204101002
222242402
002101002
002222222