70
000222222222
000200020002
000200000002
222225220022
200011100020
202025222422
204000040002
222228020002
000022222222