76
00022222222
22220000102
20040404182
20012222122
20414040020
20010022220
22222220000