86
2222000002222000
2002222222112220
2040404000111120
2040004402555120
2040404000115120
2004040400515120
2204040401515122
2004040401515182
2004040402515122
2040404002115120
2040004402555120
2040404002111120
2002222222112220
2222000002222000