92
002222200000
002000222222
222421000002
204011120402
200802540002
222200002222
000222222000