96
00022222222220
22221111110020
20001111120020
20021111110220
22022224224200
20400404000222
28440000220002
20200442200202
20004002044002
20040040002402
22220002040402
00020002000002
00022222222222